7
aeroway=aerodrome
29
1189513985
1192542595
1321544198
1183684102
1191478922
1194803474
1187121683
1188236821
1187119129
1149049244
1187134878
1321544479
1193624352
1103651620
1173452966
1193236904
1183641769
1158156597
1183630409
1159066064
1187130579
1321544156
1174116575
1321544041
1321544433
1321544050
1173425143
1174124538
1173452796
aeroway=gate
29
1188414080
1187119111
1173486863
1190255759
1214153113
1185825698
1103651751
1173440045
1321544497
1187130547
1173440051
1158156467
1187088699
1174116798
1173452741
1160057029
1183708743
1214153675
1187130573
1183721294
1183684053
1321544278
1166052442
1178253275
1187130588
1316588128
1158156518
1187131626
1113220217
aeroway=terminal
29
1173444099
1185825669
1174116747
1183701904
1183641872
1183684240
1321544098
1187134883
1159071653
1179851689
1149052086
1173452861
1174117312
449815872
1179851713
278486602
1179847757
1103651789
1187086162
1187136595
1103651666
1187130578
1321544285
1173486693
1188232557
1192542574
269567733
278486901
269567734
aerodrome:type=*
29
1321544199
1113220361
1191507722
1173486733
1194804881
449815827
1173425045
1188236821
1183683996
1321544351
1187121698
1321544228
1174116517
1158156458
1187130542
1158164526
1187139252
1183630393
1299524303
1113220439
1159931360
1159931367
1174116840
1321544042
449815915
449815789
1173487091
1321544053
1174120954
aeroway=heliport
29
1113220226
263571587
1187086340
1173452809
1189513994
1174117003
1193124746
1174116751
1173457680
449815827
1308679576
1187119131
1187119133
1194803497
449815989
1158156470
1183623239
1190301009
1103651672
1159931482
1031684701
1173440097
1174116964
1155503719
1173486579
1190311156
278486900
1191453561
1113220476
iata=*
29
1113220354
1167369733
1183630346
1173486614
1187542810
1173452968
278730280
1159931437
1321544502
1188232505
1173444027
449815870
1174124486
1113220295
278486602
1174116938
449815883
1174116690
1173494099
1159066069
1193302874
1173497308
25449702
445088873
1299524333
1298415728
1173486583
1113220345
1174117114
landuse=military
29
1188414080
1149049222
1194804873
1174117144
1155459100
1173487005
1185825694
1193130399
1158156453
1173452971
445099442
1188198835
25449396
1174116792
449815867
1173425086
25449283
1178253261
1174116431
1321544656
1187535059
1193320918
1191393751
1321544157
1174124515
1178253296
1174120949
1183684088
1103651839